faida  -- pato libakialo baada ya kuondoa gharama za kufanya biashara kv: ununuzi na usafirishaji.; faida, tijara, kivuno, chumo, ziada
tijara  -- pato libakialo baada ya kuondoa gharama za kufanya biashara kv: ununuzi na usafirishaji.; faida, tijara, kivuno, chumo, ziada
kivuno  -- pato libakialo baada ya kuondoa gharama za kufanya biashara kv: ununuzi na usafirishaji.; faida, tijara, kivuno, chumo, ziada
chumo  -- pato libakialo baada ya kuondoa gharama za kufanya biashara kv: ununuzi na usafirishaji.; faida, tijara, kivuno, chumo, ziada
ziada  -- pato libakialo baada ya kuondoa gharama za kufanya biashara kv: ununuzi na usafirishaji.; faida, tijara, kivuno, chumo, ziada
hasara  -- ukosefu wa faida; hali ya kupoteza pato au mali katika biashara
bei  -- kiwango cha pesa kununulia au kuuzia bidhaa au huduma fulani
uuzaji wa rejareja  -- uuzaji wa kiasi kidogo kidogo
uuzaji wa jumla  -- uuzaji wa kwa pamoja
bei rafi  -- bei ambayo haipunguzwi
kipimo rafi  -- kipimo ambacho hakipunguzwi
bei ya kuruka  -- bei isiyokubalika kisheria/haramu
rasilimali  -- ujumla wa mali yaanyomilikiwa na mtu au nchi
malighafi  -- mali yanayotumika kutengeneza vitu vingine km: pamba ni malighafi ya kutengenezea nguo
maliasili  -- utajiri kama vile madini, misitu, maziwa, mito, anga vinavyopatikana katika mazingira
uwekezaji  -- kutumia pesa/mali ili kuzalisha fedha/mali zaidi  [ilikupata faida]
kitegauchumi  -- rasilimali kv: kiwanda inayotumika kuzalisha mali
ujasiriamali  -- uwekezaji mtaji katika biashara
mtaji  -- mali ya kuanzisha biashara au kuipanulia
ulanguzi  -- ufichaji wa bidhaa ili bei yazo iruke
magendo  -- upigaji biashara kwa njia haramu/isiyo halali
chenji  -- pesa zinazobaki baada ya kununua kitu
maduhuli  -- mapato; mauzo
maduhuli  -- bidhaa ambazo hununuliwa kutoka nchi za nje
mahuruji  -- bidhaa zinazouzwa nchi za nje
ushuru  -- kodi ya kuingiza bidhaa nchini au kuziuza/ada ya forodha
ruzuku  -- pesa zinazotolewa na serikali kwa idara mbalimbali ili kujiendeleza
mshtiri  -- mnunuzi
mteja  -- aendaye kununua bidhaa au huduma
wakala  -- ajenti
utandawazi  -- utaratibu wa mataifa kushirikiana katika nyanja mbalimbali kv: biashara
ubinafsishaji  -- hali ya kusababisha mali ya umma imilikiwe na watu binafsi
ubia  -- ushirikiano wa watu wawili au zaidi katika shughuli kv: ya biashara
hawala  -- hundi/cheki
amana  -- kitu unachomwekea mwenzako hadi atakapokihitaji
turuhani  -- kiwango kinachotolewa kutoka katika bei iliyotangazwa
kipunguzo  -- kiwango kinachotolewa kutoka katika bei iliyotangazwa
ikfisadi  -- uangalifu katika kutumia fedha/mali
ubepari  -- mfumo wa uchumi ambao unawawezesha watu wachache kumiliki rasilimali na vitegauchumi
ukiritimba  -- hali ya kuzuia wengine kufanya biashara au kushindana katika biashara
dukakuu  -- duka kubwa ambapo wateja hujichukulia bidhaa watakazo kutoka rafuni
hisa  -- sehemu ya mtaji katika biashara
