-alaza  -- scrape, graze  (kizaramo)
-ambita  -- lick  (kizaramo)
-andalia  -- prepare  (kizaramo)
-asa ugata  -- lie on one's back  (kizaramo)
-asa utulo  -- sleep  (kizaramo)
-bakala  -- spread, smear on  (kizaramo)
-banza  -- increase  (kizaramo)
-bavi  -- steal  (kizaramo)
-bena vindi  -- kneel  (kizaramo)
-beta  -- bend  (kizaramo)
-beya  -- shave  (kizaramo)
-bita  -- pass, surpass  (kizaramo)
-bokela  -- receive  (kizaramo)
-bulula  -- pull, drag  (kizaramo)
-bwanda mate  -- spit  (kizaramo)
-bwela  -- return  (kizaramo)
-bwihna moto  -- roast  (kizaramo)
-cha  -- dawn  (kizaramo)
-cha  -- dawn, daybreak  (kizaramo)
-changanya  -- mix, put together  (kizaramo)
-chinja  -- slaughter  (kizaramo)
-chnyanha  -- wash (clothes)  (kizaramo)
-chogwa  -- sink, be drowned  (kizaramo)
-chola  -- become bad, rotten  (kizaramo)
-choza  -- walk  (kizaramo)
-chuja  -- filter, strain  (kizaramo)
-dega  -- separate, leave each other  (kizaramo)
-deha  -- draw (water from well)  (kizaramo)
-deka  -- vomit  (kizaramo)
-diswa  -- set (of the sun)  (kizaramo)
-doda  -- get wet  (kizaramo)
-doda  -- go back, return  (kizaramo)
-dumba  -- be afraid  (kizaramo)
-dunda  -- pound (grain in a mortar to ge  (kizaramo)
-duta  -- carry  (kizaramo)
-dutika  -- pile up, pile loads on head  (kizaramo)
-dya  -- eat  (kizaramo)
-eleza  -- copy a pattern  (kizaramo)
-enela  -- be spread out  (kizaramo)
-enyewe  -- self  (kizaramo)
-esa  -- pull  (kizaramo)
-kufa  -- die  (kizaramo)
-fagila  -- sweep  (kizaramo)
-fanana  -- match, harmonise  (kizaramo)
-fimiliza  -- close (eyes, mouth)  (kizaramo)
-fisa  -- hide  (kizaramo)
-fua chuma  -- forge  (kizaramo)
-fula  -- break wind  (kizaramo)
-fuma  -- weave, knit  (kizaramo)
-fundika  -- plait  (kizaramo)
-funga  -- tie up  (kizaramo)
-fungula  -- open (=set ajar) a door  (kizaramo)
-fyonza  -- suck  (kizaramo)
-gala  -- bring, fetch  (kizaramo)
-ganda  -- coagulate  (kizaramo)
-gela  -- place, put  (kizaramo)
-gelegeza  -- think, imagine  (kizaramo)
-geluka  -- alter, change  (kizaramo)
-geza  -- try  (kizaramo)
-geza  -- examine, measure, test  (kizaramo)
-geza  -- imitate  (kizaramo)
-gida  -- pour  (kizaramo)
-goga  -- grasp, hold in arm  (kizaramo)
-goga  -- seize  (kizaramo)
-gonga  -- strike, knock  (kizaramo)
-gubika  -- cover (up)  (kizaramo)
-gudema  -- tremble, shake  (kizaramo)
-gula  -- buy  (kizaramo)
-guruka  -- jump, leap  (kizaramo)
-guta  -- shout  (kizaramo)
-gwa  -- fall  (kizaramo)
-gwaya  -- shiver  (kizaramo)
-gwelela  -- divide  (kizaramo)
-hala  -- scrape  (kizaramo)
-hamba  -- decorate  (kizaramo)
-hamha  -- move away, migrate  (kizaramo)
-handika  -- plant, sow  (kizaramo)
-hangusa  -- wipe  (kizaramo)
-heta  -- winnow  (kizaramo)
-hikuniza  -- be round  (kizaramo)
-himba  -- dig  (kizaramo)
-hinduka  -- turn round, change  (kizaramo)
-hinduka  -- turn upside down, turn over  (kizaramo)
-hnunga  -- put together, compose  (kizaramo)
-homa  -- roast  (kizaramo)
-hona  -- escape, recover  (kizaramo)
-honda  -- crush by pounding, pulverise  (kizaramo)
-hoza  -- cool, cure, heal  (kizaramo)
-hulika  -- hear  (kizaramo)
-humwa  -- overcome, win, vanquish  (kizaramo)
-hungula  -- diminish, grow less  (kizaramo)
-husila  -- stack, pile up  (kizaramo)
-ibana  -- pinch, make narrow  (kizaramo)
-ibiga  -- fight  (kizaramo)
-ibilia  -- sink  (kizaramo)
-ibwatiza  -- quarrel  (kizaramo)
-iduila  -- swear  (kizaramo)
-ififila  -- fade, disappear  (kizaramo)
-ifunza  -- learn  (kizaramo)
-igamba  -- boast, brag, praise oneself  (kizaramo)
-igolosa  -- stretch oneself  (kizaramo)
-igolosa  -- lie down  (kizaramo)
-igwa  -- drop, throw down  (kizaramo)
-ika  -- put, place, set  (kizaramo)
-ikagoya  -- look after, care for  (kizaramo)
-ikunza  -- twist  (kizaramo)
-ikwala  -- stumble  (kizaramo)
-ima  -- stand  (kizaramo)
-imba  -- sing  (kizaramo)
-imwagila  -- wash, take a bath  (kizaramo)
-imza  -- follow  (kizaramo)
-inegeni  -- spread, scatter  (kizaramo)
-ingila  -- go in, come in  (kizaramo)
-inula  -- uncover, reveal  (kizaramo)
-isemwa  -- forget  (kizaramo)
-isigala  -- remain, stay  (kizaramo)
-itenga  -- separate, set apart  (kizaramo)
-itinhana  -- be adjacent, border  (kizaramo)
-jibu  -- answer  (kizaramo)
-kaga  -- get lost  (kizaramo)
-kahna  -- cut  (kizaramo)
-kahnakahna  -- cut, lop  (kizaramo)
-kakala  -- be, become  (kizaramo)
-kala  -- sit  (kizaramo)
-kama  -- wring  (kizaramo)
-kamula  -- squeeze, milk  (kizaramo)
-kema  -- call  (kizaramo)
-kimbila  -- run  (kizaramo)
-kimla  -- cook in water or fat  (kizaramo)
-kolela  -- please, satisfy  (kizaramo)
-kolola  -- cough  (kizaramo)
-koma  -- kill  (kizaramo)
-koma  -- put to death  (kizaramo)
-kombeleza  -- hollow out  (kizaramo)
-kong'ha  -- suck (the breast)  (kizaramo)
-koza  -- urinate  (kizaramo)
-kuluza  -- snore, snort  (kizaramo)
-kunza  -- bend, twist  (kizaramo)
-kupia  -- store up, collect  (kizaramo)
-kupila  -- sweep up, collect in a heap (r  (kizaramo)
-kuruga  -- stir, mix by stirring  (kizaramo)
-kusanya  -- sweep up, collect in a heap (r  (kizaramo)
-kwawa  -- itch  (kizaramo)
-kwela  -- climb, ascend  (kizaramo)
-lagiza  -- order, direct  (kizaramo)
-lanza  -- taste  (kizaramo)
-lava  -- give away (present)  (kizaramo)
-lawa  -- go out, go away  (kizaramo)
-legela  -- be loose, faint, weak  (kizaramo)
-leka  -- leave (off)  (kizaramo)
-lela  -- bring up (a child)  (kizaramo)
-leligwa  -- be born  (kizaramo)
-lema  -- reject, refuse  (kizaramo)
-lema  -- deny  (kizaramo)
-lema  -- refuse, say no  (kizaramo)
-liga  -- abuse  (kizaramo)
-liha  -- pay  (kizaramo)
-lima  -- cultivate  (kizaramo)
-lingana  -- resemble  (kizaramo)
-loa  -- fish  (kizaramo)
-loga  -- bewitch  (kizaramo)
-lohola  -- fish up, pull out  (kizaramo)
-lola  -- see  (kizaramo)
-lola  -- look at, examine  (kizaramo)
-londa  -- look for, hand around (to get  (kizaramo)
-londa  -- want, need, wish  (kizaramo)
-longa  -- speak  (kizaramo)
-longela  -- say to, tell to  (kizaramo)
-losoka  -- shiver, shudder  (kizaramo)
-lota nzozi  -- dream  (kizaramo)
-lulumka  -- swell  (kizaramo)
-luma  -- bite  (kizaramo)
-lumba  -- mould (pottery)  (kizaramo)
-lumbuka  -- melt  (kizaramo)
-lumwa  -- become burnt  (kizaramo)
-lumwa  -- be ill, groan  (kizaramo)
-lunga  -- mix (ingredients)  (kizaramo)
-mayawi  -- yawn  (kizaramo)
-mbatila  -- embrace  (kizaramo)
-mbuka  -- remember  (kizaramo)
-mega tula  -- break, snap  (kizaramo)
-mema  -- become full  (kizaramo)
-memeza  -- fill  (kizaramo)
-meza  -- swallow  (kizaramo)
-moso  -- left-hand  (kizaramo)
-munza  -- follow (in order)  (kizaramo)
-mwihila  -- hate, detest  (kizaramo)
-neneha  -- thicken, fatten  (kizaramo)
-ng'ola  -- pull up, root up  (kizaramo)
-ng'uhna  -- spread  (kizaramo)
-ngwa  -- drink  (kizaramo)
-nhata  -- get, obtain  (kizaramo)
-nogela  -- love, want  (kizaramo)
-nokala  -- dwell  (kizaramo)
-nola  -- sharpen  (kizaramo)
-nuh'gaa  -- smell (bad)  (kizaramo)
-nula  -- lift up, pick up  (kizaramo)
-nusa  -- smell out, sniff  (kizaramo)
-nya mavi  -- defecate  (kizaramo)
-nyala  -- dry up, become dry  (kizaramo)
-nyongela  -- be shriveled, wrinkled  (kizaramo)
-nyongoza  -- increase, make greater  (kizaramo)
-nyunyuha  -- drizzle  (kizaramo)
-oga  -- bathe  (kizaramo)
-papa  -- carry a child on the back (in  (kizaramo)
-pelemba  -- hunt  (kizaramo)
-pepea  -- fan, wave  (kizaramo)
-peperusha  -- blow away  (kizaramo)
-peta  -- count  (kizaramo)
-peta  -- explain  (kizaramo)
-pula  -- lend, borrow  (kizaramo)
-pula  -- ask for  (kizaramo)
-sagula  -- choose  (kizaramo)
-sanga  -- assemble, collect  (kizaramo)
-sasa  -- ferment, turn sour  (kizaramo)
-segela  -- leave, go away  (kizaramo)
-segeza  -- push  (kizaramo)
-seka  -- laugh  (kizaramo)
-shiliza  -- do, complete, finish  (kizaramo)
-shona  -- sew  (kizaramo)
-shuta  -- break wind  (kizaramo)
-sigula  -- wave, let off a trap, remove a  (kizaramo)
-sindika  -- press out (oil seed, sugar can  (kizaramo)
-sogota  -- twist  (kizaramo)
-sola  -- take, carry  (kizaramo)
-soma  -- read  (kizaramo)
-suluza  -- wash  (kizaramo)
-sungusa  -- rub  (kizaramo)
-susumila  -- be lame  (kizaramo)
-tamba  -- resemble [very closely]  (kizaramo)
-tamba  -- dance [of men, to show courage] (kizaramo)
-tambala  -- crawl, creep  (kizaramo)
-tambika  -- make offerings to the dead  (kizaramo)
-tegeleza  -- listen  (kizaramo)
-teleguka  -- slip, be slippery  (kizaramo)
-teleka  -- cook  (kizaramo)
-temela  -- be pregnant  (kizaramo)
-tenda  -- arrange, put right, repair  (kizaramo)
-tenda  -- do  (kizaramo)
-tenda  -- act  (kizaramo)
-timba  -- grind (grain with a millstone)  (kizaramo)
-tindiga  -- stir  (kizaramo)
-tisha  -- threaten  (kizaramo)
-toa  -- beat  (kizaramo)
-tobola  -- spoil, blind  (kizaramo)
-tulika  -- split, crack  (kizaramo)
-tuma  -- send  (kizaramo)
-tumila  -- use  (kizaramo)
-uza  -- sell  (kizaramo)
-vala  -- wear  (kizaramo)
-vika  -- arrive  (kizaramo)
-vika  -- meet  (kizaramo)
-vina  -- dance  (kizaramo)
-vugula  -- open  (kizaramo)
-vuka  -- cross (a river)  (kizaramo)
-vula  -- take off (clothes)  (kizaramo)
-vumbula tambula  -- stir up  (kizaramo)
-wafunza  -- teach, instruct  (kizaramo)
-wanda  -- arrange, put in order  (kizaramo)
-winga  -- chase (away)  (kizaramo)
-yanika  -- set out to dry  (kizaramo)
-zahila londa  -- search for  (kizaramo)
-zahirazahira  -- search diligently  (kizaramo)
-zega  -- scratch, grate  (kizaramo)
-zenga  -- build  (kizaramo)
-ziba  -- stop up, fill a hole  (kizaramo)
-zika  -- bury  (kizaramo)
-zima  -- quench, extinguish  (kizaramo)
-zingiliza  -- tie up  (kizaramo)
-zoela  -- get accustomed  (kizaramo)
-zuhula  -- take the skin off, bruise  (kizaramo)
-zuila  -- tie (=fasten)  (kizaramo)
-zunguluka  -- go round, turn round  (kizaramo)
-zungulusa  -- turn round  (kizaramo)
anga  -- light, sky  (kizaramo)
asali  -- honey  (kizaramo)
babu  -- grandfather  (kizaramo)
bata  -- duck  (kizaramo)
beberu  -- he-goat  (kizaramo)
beho  -- cold  (kizaramo)
beleko  -- womb  (kizaramo)
bibi  -- grandmother  (kizaramo)
bigalo  -- bull  (kizaramo)
biki  -- tree  (kizaramo)
bobotola  -- hip  (kizaramo)
bui  -- spider  (kizaramo)
bula  -- frog  (kizaramo)
bustani  -- garden  (kizaramo)
buyu  -- calabash  (kizaramo)
bwana mkuu  -- master  (kizaramo)
bwawa  -- lake  (kizaramo)
chambo  -- bait  (kizaramo)
chanda  -- finger  (kizaramo)
chanda  -- toe  (kizaramo)
chaza  -- oyster  (kizaramo)
cheo  -- size, measure  (kizaramo)
chokaa  -- lime, whitewash  (kizaramo)
choni  -- what?  (kizaramo)
chui  -- leopard  (kizaramo)
chuma cha mhula  -- steel  (kizaramo)
dako  -- buttock  (kizaramo)
dala  -- hard  (kizaramo)
damu  -- blood  (kizaramo)
daraja  -- bridge  (kizaramo)
dawati  -- basket of open wicker-work  (kizaramo)
dekanane  -- eight  (kizaramo)
dete  -- reed  (kizaramo)
dhabibu  -- sacrifice  (kizaramo)
dibovu  -- rotten  (kizaramo)
dibwa  -- dog  (kizaramo)
dikwe  -- filth  (kizaramo)
dinoga  -- fat (of animals)  (kizaramo)
dipa  -- ripen  (kizaramo)
ditwi  -- head  (kizaramo)
dumba  -- coward  (kizaramo)
dya  -- there  (kizaramo)
farasi  -- horse  (kizaramo)
figo  -- kidney  (kizaramo)
finga  -- egg  (kizaramo)
fuawe  -- anvil  (kizaramo)
fukufuku  -- snail, slug  (kizaramo)
fumvu  -- bunch  (kizaramo)
fungo  -- genet (=kind of speckled civet  (kizaramo)
gahungula  -- dry up, ebb  (kizaramo)
ganda  -- skin  (kizaramo)
ganza  -- fist  (kizaramo)
ganza da mgulu  -- calf of the leg  (kizaramo)
gembe  -- hoe  (kizaramo)
gobole  -- gun  (kizaramo)
guhi  -- short  (kizaramo)
gutwi  -- ear  (kizaramo)
gwaha  -- armpit  (kizaramo)
gwewe  -- you (sg.)  (kizaramo)
habehi  -- near  (kizaramo)
hambaga  -- shoulder  (kizaramo)
hanhu  -- place  (kizaramo)
hano  -- here  (kizaramo)
hanze  -- outside  (kizaramo)
hemhemu  -- spring (of water)  (kizaramo)
hnakahnaka  -- rubbish, garbage  (kizaramo)
hnalaka  -- divorce  (kizaramo)
hnama  -- final, decisive  (kizaramo)
hnandu  -- centipede  (kizaramo)
hnano  -- five  (kizaramo)
hngwilu  -- thirst  (kizaramo)
hnondo  -- star  (kizaramo)
hnunda  -- fruit  (kizaramo)
hnunguja  -- tomato  (kizaramo)
hnyupa  -- bottle  (kizaramo)
holumwa  -- grief, sorrow  (kizaramo)
hombe  -- eyelash  (kizaramo)
hovu  -- foam  (kizaramo)
hovu  -- foam  (kizaramo)
hudwa  -- (small) ant  (kizaramo)
huhu  -- lung  (kizaramo)
humuli  -- breath, breathing  (kizaramo)
hyumvi?  -- salt  (kizaramo)
igolo  -- yesterday  (kizaramo)
ijya  -- she, he  (kizaramo)
ikafi  -- paddle  (kizaramo)
ikilo  -- night  (kizaramo)
imala  -- cease, finish  (kizaramo)
imisi  -- day-time  (kizaramo)
imwe  -- one  (kizaramo)
inda  -- pregnancy  (kizaramo)
inge  -- scorpion  (kizaramo)
ini  -- liver  (kizaramo)
inoga  -- sweet, pleasant  (kizaramo)
inyala  -- dry  (kizaramo)
ipa  -- ripen  (kizaramo)
isi  -- earth, land  (kizaramo)
isi inyala  -- (dry) land  (kizaramo)
isi yetu  -- (our) country  (kizaramo)
isota  -- tip, point  (kizaramo)
ita  -- pour away  (kizaramo)
iyosi  -- smoke  (kizaramo)
jasho  -- sweat  (kizaramo)
jiko  -- fireplace, hearth, kitchen  (kizaramo)
jimbo  -- district, province, country  (kizaramo)
jipu  -- boil, abscess  (kizaramo)
jiwe  -- stone  (kizaramo)
kaakaa  -- palate  (kizaramo)
kacha  -- tomorrow  (kizaramo)
kala da moto  -- embers  (kizaramo)
kali  -- fierce, sharp  (kizaramo)
kane  -- four  (kizaramo)
kanoga  -- beautiful  (kizaramo)
kanza  -- cheek  (kizaramo)
kasila  -- oar  (kizaramo)
kasuku  -- parrot  (kizaramo)
kati  -- inside  (kizaramo)
kazi  -- work  (kizaramo)
kenda  -- nine  (kizaramo)
kibambaza  -- wall  (kizaramo)
kibofu  -- bladder  (kizaramo)
kibogwa  -- (sweet) potato  (kizaramo)
kibuha  -- light in weight  (kizaramo)
kiburi  -- abuse  (kizaramo)
kidali  -- chest  (kizaramo)
kidevu  -- chin  (kizaramo)
kidumala  -- unripe, half grown  (kizaramo)
kifaru  -- rhinoceros  (kizaramo)
kifo  -- death  (kizaramo)
kifundo  -- knot  (kizaramo)
kigata  -- palm (of hand)  (kizaramo)
kigoda  -- seat, stool, chair  (kizaramo)
kigongo  -- hump (of hunchback)  (kizaramo)
kiha  -- bad  (kizaramo)
kihanga  -- face  (kizaramo)
kihili  -- thigh  (kizaramo)
kihili  -- thigh  (kizaramo)
kihinza  -- virgin (bride), girl  (kizaramo)
kihnu  -- thing  (kizaramo)
kiisi  -- village  (kizaramo)
kijito  -- brook, stream  (kizaramo)
kikanda  -- knead  (kizaramo)
kiko  -- elbow  (kizaramo)
kikunogela  -- befit, suit  (kizaramo)
kikuvu  -- navel  (kizaramo)
kikuwi  -- tortoise  (kizaramo)
kikwama  -- cattle  (kizaramo)
kilingo  -- hut  (kizaramo)
kilonda  -- sore  (kizaramo)
kimba  -- corpse  (kizaramo)
kimbwego  -- stick  (kizaramo)
kindi  -- squirrel  (kizaramo)
kingofi  -- hook (to pull down branches in  (kizaramo)
kinyala  -- shame  (kizaramo)
kinyala  -- shame, disgrace  (kizaramo)
kipofu  -- blind person  (kizaramo)
kisiginho  -- heel  (kizaramo)
kisima  -- well  (kizaramo)
kisiwa  -- island  (kizaramo)
kitovu  -- navel  (kizaramo)
kiwele  -- udder  (kizaramo)
kiya  -- pot, vessel  (kizaramo)
kiyoga  -- mushroom  (kizaramo)
ko-choza  -- travel  (kizaramo)
ko-kukila  -- close  (kizaramo)
koja  -- bead(s)  (kizaramo)
kola  -- snail  (kizaramo)
kolongo  -- pit, hole  (kizaramo)
kolumwa  -- sick  (kizaramo)
kombe  -- shell  (kizaramo)
kotza  -- sperm  (kizaramo)
kulu  -- great, powerful  (kizaramo)
kumi  -- ten  (kizaramo)
kuneti  -- weight, rhythm  (kizaramo)
kungulu  -- crow  (kizaramo)
kutali  -- far  (kizaramo)
kwame  -- bark (of tree)  (kizaramo)
kwembe  -- skin  (kizaramo)
lelo  -- today  (kizaramo)
lila  -- righthand  (kizaramo)
lubavu  -- rib  (kizaramo)
lugoho  -- shin (bone)  (kizaramo)
lukuli  -- body  (kizaramo)
lukulu  -- old  (kizaramo)
lulimi  -- tongue  (kizaramo)
lusazi  -- bed  (kizaramo)
lwembe  -- razor  (kizaramo)
lwivi  -- door  (kizaramo)
magota  -- stem of maize, millet  (kizaramo)
mahozi  -- tears  (kizaramo)
mahuhu  -- lung  (kizaramo)
majusi  -- feathers, fur  (kizaramo)
makala  -- charcoal  (kizaramo)
malogwe  -- maize  (kizaramo)
malua  -- flower  (kizaramo)
mama  -- mother  (kizaramo)
mamba  -- crocodile  (kizaramo)
manzhi  -- water  (kizaramo)
masango  -- (brass) wire  (kizaramo)
mashua  -- boat  (kizaramo)
masika  -- rainy season  (kizaramo)
mate  -- spittle  (kizaramo)
matombo  -- breast  (kizaramo)
matombo  -- milk  (kizaramo)
matombo  -- milk  (kizaramo)
matope  -- mud, mire  (kizaramo)
matumbo  -- intestines  (kizaramo)
mavi  -- excrement, dung  (kizaramo)
mazuka  -- sudden apparition, ghost  (kizaramo)
mbavi  -- thief  (kizaramo)
mbegu  -- seed  (kizaramo)
mbeho  -- shadow, shade  (kizaramo)
mbewa  -- rat  (kizaramo)
mbigalo  -- male  (kizaramo)
mbingu  -- sky  (kizaramo)
mbolo  -- penis  (kizaramo)
mbuli  -- word  (kizaramo)
mbuli  -- affair  (kizaramo)
mbuzi  -- goat  (kizaramo)
mchirizi  -- line, row  (kizaramo)
mchuzi  -- broth  (kizaramo)
mdewa  -- chief, headman  (kizaramo)
mfalume  -- king  (kizaramo)
mfumo  -- chief  (kizaramo)
mfungu  -- (earthenware vessel for servin  (kizaramo)
mfupa  -- bone  (kizaramo)
mganga  -- medicine man  (kizaramo)
mgati  -- inside  (kizaramo)
mge  -- backbone  (kizaramo)
mgeni  -- stranger, guest  (kizaramo)
mgoha  -- spear  (kizaramo)
mgoi  -- python  (kizaramo)
mgomba  -- banana (plant)  (kizaramo)
mgulu  -- leg, foot  (kizaramo)
mgunda  -- cultivated ground  (kizaramo)
mhambaga  -- shoulder  (kizaramo)
mhambaga  -- chest (of animals and birds)  (kizaramo)
mhani  -- louse  (kizaramo)
mhawi  -- sorcerer  (kizaramo)
mhula  -- nose  (kizaramo)
mhumbu  -- testicle  (kizaramo)
mia  -- hundred  (kizaramo)
miasi  -- sneeze  (kizaramo)
midete  -- reed  (kizaramo)
migota  -- bullrush millet  (kizaramo)
mikuzha  -- boundary  (kizaramo)
mipukupuku  -- dust, cloud of dust  (kizaramo)
misenga  -- sand  (kizaramo)
mishipa  -- vein  (kizaramo)
misizi  -- soot  (kizaramo)
mji  -- town  (kizaramo)
mkahna  -- judge  (kizaramo)
mkate  -- bread  (kizaramo)
mke  -- wife  (kizaramo)
mkila  -- tail  (kizaramo)
mkoka  -- lazy  (kizaramo)
mkondo  -- stream, current  (kizaramo)
mkono  -- arm, hand  (kizaramo)
mkozo  -- urine  (kizaramo)
mkulu  -- head, chief person  (kizaramo)
mkulu  -- (older) brother  (kizaramo)
mkulu wake  -- (his) sister, (her) brother  (kizaramo)
mkwe  -- father-in-law, mother-in-law  (kizaramo)
mlilo  -- sound, cry  (kizaramo)
mlima  -- hill  (kizaramo)
mlima  -- mountain  (kizaramo)
mlumba  -- (professional) hunter  (kizaramo)
moga  -- fear  (kizaramo)
mola  -- god  (kizaramo)
moto  -- fire  (kizaramo)
mshipi  -- fishing line  (kizaramo)
mtali tali  -- long  (kizaramo)
mtambo  -- spring, machine  (kizaramo)
mtawala  -- chief  (kizaramo)
mtego  -- snare, trap  (kizaramo)
mtemba  -- tobacco pipe  (kizaramo)
mtembetini  -- top, peak  (kizaramo)
mto  -- river  (kizaramo)
mtohi  -- pestle  (kizaramo)
mtondo  -- the day after tomorrow  (kizaramo)
mtondogolo  -- the day before yesterday  (kizaramo)
mtumbwi  -- canoe  (kizaramo)
mtumwa  -- slave, bondservant  (kizaramo)
mtwanzi  -- woman  (kizaramo)
muhini  -- handle, haft  (kizaramo)
muhnu  -- person  (kizaramo)
muhulo  -- bush  (kizaramo)
mulala  -- spot, speckle  (kizaramo)
mulelo  -- offspring  (kizaramo)
mulomo  -- lip  (kizaramo)
mulomo  -- mouth  (kizaramo)
mume  -- husband  (kizaramo)
mungu  -- god  (kizaramo)
muswa  -- termite  (kizaramo)
muwa  -- sugar cane  (kizaramo)
muwale  -- raphia palm  (kizaramo)
mvaze  -- clothe  (kizaramo)
mvili  -- hair  (kizaramo)
mvula  -- rain  (kizaramo)
mvulu  -- hole, nest  (kizaramo)
mvwizi  -- number  (kizaramo)
mwaka  -- year  (kizaramo)
mwamba  -- rock  (kizaramo)
mwana  -- child  (kizaramo)
mwana  -- child  (kizaramo)
mwanza  -- journey  (kizaramo)
mwele  -- knife  (kizaramo)
mwema  -- good  (kizaramo)
mwetu  -- home  (kizaramo)
mwewe  -- kite  (kizaramo)
mweye  -- you (pl.)  (kizaramo)
mwezi  -- moon  (kizaramo)
mwhani  -- beach, coast  (kizaramo)
mwiko  -- spoon  (kizaramo)
mwiko wa wana  -- hyena  (kizaramo)
mwitu  -- forest  (kizaramo)
mzazi  -- he who begets (=parent)  (kizaramo)
mzee  -- old person  (kizaramo)
mzigo  -- burden, load  (kizaramo)
mzimu  -- spirit (of dead person)  (kizaramo)
mzizi  -- root  (kizaramo)
mzuka  -- evil spirit  (kizaramo)
mzungu  -- white man  (kizaramo)
n'hambala  -- cloth  (kizaramo)
ndama  -- calf  (kizaramo)
ndatu  -- three  (kizaramo)
ndevu  -- beard  (kizaramo)
ndoa  -- marriage  (kizaramo)
ndoana  -- fish-hook  (kizaramo)
ndodo  -- small  (kizaramo)
ndugu  -- brother, relative, fellow-trib  (kizaramo)
ndui  -- smallpox  (kizaramo)
ng'anda  -- house  (kizaramo)
ng'ombe  -- cow  (kizaramo)
ngadu  -- crab  (kizaramo)
ngalawa mtombo  -- dug-out canoe  (kizaramo)
ngalo  -- shield  (kizaramo)
ngawa  -- civet cat  (kizaramo)
ngodi  -- firewood  (kizaramo)
ngoma  -- drum  (kizaramo)
nguku  -- hen, fowl  (kizaramo)
nguo  -- clothes, material  (kizaramo)
nguruwe  -- pig  (kizaramo)
nguvu  -- strength, power  (kizaramo)
ngwelela  -- give  (kizaramo)
nhamba  -- lobster  (kizaramo)
nhanga  -- guinea-fowl  (kizaramo)
nhembo  -- elephant  (kizaramo)
nhezo  -- carpenter's adze  (kizaramo)
nhokwa unyalile  -- hay  (kizaramo)
nhombe  -- fingernail  (kizaramo)
nhondolo  -- sheep  (kizaramo)
nhoo  -- banana (fruit)  (kizaramo)
nhugi  -- eagle, bird of prey  (kizaramo)
nhulambi  -- (reddish-brown biting) ant  (kizaramo)
nhulu  -- large, great  (kizaramo)
nhuluzi  -- whistling  (kizaramo)
ni  -- dream  (kizaramo)
nie  -- I  (kizaramo)
niye  -- I  (kizaramo)
njiwa  -- (red-eyed) dove  (kizaramo)
nkebe  -- pot, mug  (kizaramo)
nokwishila  -- highest point, utmost  (kizaramo)
nongo  -- (earthen) cooking pot  (kizaramo)
nundu  -- hump (of cow)  (kizaramo)
nungu  -- porcupine  (kizaramo)
nyama  -- meat  (kizaramo)
nyama  -- animal  (kizaramo)
nyamala  -- be quiet  (kizaramo)
nyati  -- buffalo  (kizaramo)
nyau  -- cat  (kizaramo)
nyenze  -- cricket  (kizaramo)
nyhani  -- baboon, ape  (kizaramo)
nyingahi?  -- how many?  (kizaramo)
nyolodoka  -- dirt  (kizaramo)
nyongela  -- weak  (kizaramo)
nyongo  -- bile  (kizaramo)
nyuki  -- bee  (kizaramo)
nyuni  -- bird  (kizaramo)
nyusi  -- eyebrow  (kizaramo)
nzala  -- hunger  (kizaramo)
nzele  -- grain  (kizaramo)
nzelu  -- white  (kizaramo)
nzige  -- locust  (kizaramo)
nzingo  -- fence, enclosure  (kizaramo)
nzogolo  -- rooster (=cock)  (kizaramo)
nzuguni  -- mosquito  (kizaramo)
nzugwana  -- youth  (kizaramo)
nzugwana  -- young man  (kizaramo)
pacha  -- twin  (kizaramo)
papasi  -- (cattle or dog) tick  (kizaramo)
pepo  -- (disembodied) spirit  (kizaramo)
punda  -- donkey  (kizaramo)
roho  -- soul, spirit  (kizaramo)
ruhusa  -- leave, permission  (kizaramo)
sango  -- peg  (kizaramo)
sauti  -- voice  (kizaramo)
saya  -- jaw (bone)  (kizaramo)
sengo  -- sword  (kizaramo)
sengo  -- scythe, sickle  (kizaramo)
shaba  -- copper, brass  (kizaramo)
shahawa  -- sperm  (kizaramo)
shangazi  -- aunt (=father's sister)  (kizaramo)
shoka  -- axe  (kizaramo)
simba  -- lion  (kizaramo)
siso  -- eye  (kizaramo)
somba  -- fish  (kizaramo)
sugulu  -- ant-hill  (kizaramo)
sungu  -- bitter  (kizaramo)
swala  -- Grant's gazelle  (kizaramo)
taa  -- lamp  (kizaramo)
tagwa  -- name  (kizaramo)
tata  -- father  (kizaramo)
tataliko  -- spark  (kizaramo)
tatangu  -- my father  (kizaramo)
tawi  -- branch  (kizaramo)
tepo  -- leaf (of tree)  (kizaramo)
titu  -- dark, black  (kizaramo)
tozi  -- ashes  (kizaramo)
tungwe  -- dew  (kizaramo)
tweye  -- we  (kizaramo)
twiga  -- giraffe  (kizaramo)
ubeho  -- wind  (kizaramo)
uchana  -- up, above  (kizaramo)
uele  -- (crippling) illness  (kizaramo)
ufa  -- groove, furrow  (kizaramo)
ufagilo  -- broom  (kizaramo)
ugimbi  -- beer  (kizaramo)
ugolo  -- tobacco  (kizaramo)
ugosi  -- neck  (kizaramo)
ugosi  -- nape (of neck)  (kizaramo)
uhalabu  -- destroy, spoil  (kizaramo)
uhawi  -- magic  (kizaramo)
uhwawi  -- witchcraft  (kizaramo)
ukoka  -- idleness, sloth  (kizaramo)
ukolo  -- clan  (kizaramo)
ulalo  -- bridge  (kizaramo)
ulongo  -- soil  (kizaramo)
uloto  -- brain  (kizaramo)
umeme  -- lightning  (kizaramo)
upinde  -- arrow  (kizaramo)
usoti  -- grass, reeds  (kizaramo)
utabibu  -- medicine (=art of medicine man  (kizaramo)
utulo  -- sleep  (kizaramo)
uwanja  -- courtyard  (kizaramo)
uzhi  -- gruel  (kizaramo)
uzi  -- string  (kizaramo)
vidodo  -- a few, not much  (kizaramo)
vindi  -- knee  (kizaramo)
vingi  -- many  (kizaramo)
vinzila  -- path  (kizaramo)
vita  -- war  (kizaramo)
wa-bili  -- two  (kizaramo)
wafanana  -- resemble  (kizaramo)
waja  -- they  (kizaramo)
wamema  -- many  (kizaramo)
wijya  -- that  (kizaramo)
wimbo  -- song  (kizaramo)
wimbo  -- song  (kizaramo)
wingu  -- cloud  (kizaramo)
wivu  -- jealousy  (kizaramo)
wose  -- all  (kizaramo)
ya kwahi?  -- which?  (kizaramo)
yalihi?  -- who?  (kizaramo)
yesaba  -- seven  (kizaramo)
yesita  -- six  (kizaramo)
yetu  -- our(s)  (kizaramo)
yotoa mvula?  -- rain  (kizaramo)
zalala  -- rubbish heap  (kizaramo)
zhino  -- tooth  (kizaramo)
ziba  -- thorn  (kizaramo)
zipa  -- ripe  (kizaramo)
ziza  -- darkness  (kizaramo)
zoga  -- corpse  (kizaramo)
zoka  -- serpent, snake  (kizaramo)
zoyo  -- heart  (kizaramo)
zua  -- sun  (kizaramo)
zuhma  -- iron  (kizaramo)
